11111100
1P0C1100
100E1100
11111100