111111111111111
1110C0000111111
11100000000C001
1C00PCE00001001
11000000C000011
111111C00000111
111111111111111