1111111111111
1C010000000C1
1P00011111001
1C0011E0000C1
1111111111111