1111111111111
1100000000001
1110PCE000001
1000000000001
1111111111111