111111111111111
111000000111111
111000000000001
1000PCE00001001
110000000000011
111111000000111
111111111111111