1111110111111
1C00000000001
1110PCE000001
1000000000001
1111111111111